################################
#             #        #       #
#  #########  ####   ##   #   #
#  #                #      #   #
#  #  #########     #######   #
#  #        #                 #
#  #  ####  #  #######  #######
#  #     #     #           #  #
#  #######  ###########   #  #
#                 #     ##### #
####  #########  #  #  #      #
   #              #  #  ####  #
####  ###########    #       #
#              #   #####  #####
#  #########   #        #     #
#                 ######  #####
#  #######  #######           #
#  #              #   #   #####
#  #  #########   #   #      #
#  #        #        #  ######
#  #######  #########        #
#                          #  #
#  #########  ############  #
#                 #     #     #
#  #########  ####  #######  #
#  #           #     #        #
#  #  #######  #  #########  #
#  #  #        #        #     #
#  #  #  ####  #########  ####
#  #  #     #                #
#  #########  ######  #####E#
################################
