##########
#S       #
#  ####  #
#  #     #
#  #  ## #
#     #  #
#####   ##
#  #     #
#     #E #
##########
